11
7
11111111111
10100010001
10001000101
11111111101
10000000001
10011111111
11111111111
